111111111111111111111111111111
100000000000000000000000000001
100000000000000000000000000001
100000000004000000001111111111
110100000111100100000000000001
110140404040404040404000000001
110110101010101010101000000001
110100000000000000000000114041
110100000000000000000000014041
110000000000000000000000114041
110000000000000000000000014041
111111111111111111111000014041
100000000000000000001000014041
100000000000000000001000014041
100000000000000000001000000001
100000001400000000001444400001
100000000000140000001111140001
110000000100140000001000000001
130000000100000000001000000401
111111111111110010001111111111